1111111111111
1001000C000C1
1000011111101
1P0011E000P01
1111111111111
